007010910
007031136
002651562
003002078
003035084
007035048
007035958